########
#      #
#    # #
#      #
#  #   #
##  #  #
#      #
########