############################################################################################################
#      #          # #  #         #  #  #  #  ########   #        #  #  # #    # #      #  #  #     #  #    # 
#### $ # ####  #  # ####   #######  #  ####  #      #   #  #  ####  #### ######   ########  #  #  ## #  #  # 
#   #  ###  #  ####        #  #     #        #####  #   #  ####     #      #    #         #  ##### #  #### # 
#  ## $  $  #        ###   #  #  ####  ####  #   #  #   ######   ######### #  ###   ####  #        #       # 
#      ###  #  #####   ####   #  #               #  #       #  ###       #    ###   #     #####  ### ####  # 
#####  ###  #  ##             #  #  ##############  #  ###   #  ######## #      #   #  ####       #     ## # 
#   #          ############                # #      #  #  ####  #      # # ###  # ###  #     ###  #  ###   # 
# ##########             ##   #########  ### #####     #   #       ##    ####   #####  #  ###  #  #     #### 
#          ############   #                        #####   #   #########    #          #  #    #  #######  # 
########              #      ####  ##############  ##      #        #  #      ## ######   #    #      ###  # 
#         ####### #############         #   #      #   #####   #### #  #  ###### #  #  ####       ######   # 
# #########     #      ##     #  #####  #  ######  #     #       #    #      #   # ####       #######  #   # 
#               #####  #   ####  #      #   #         ############  ## ## ####   # #   ####  #      #  #   # 
# ##########             ##   #########     ### #####    #   ############ #### ######### #     # #  ######## 
#          ############   #                           ####   #    #     #    #        #  ####### #  #   ## # 
########              #      ####  ##############  ####  #######  #  #  #### # #####  #  #       #  #   #  # 
#  ##      ###  ###   ####   ###         ###        #    #        #  #    # ## #      #  #########  #####  # 
#  #   #####       #             #######    #   ####   ### #####  # ##### # ######### #  #  ##   ##   #    #
#   #  ###  #  ####        #  #     #        #####  #  #   #  #     #  #  #         # #  #  #  # ######  # # 
#  ##       #        ###   #  #  ####  ####  #   #  #      #  ######## ########## # ############ #    #### # 
#      ###  #  #####   ####   #  #               #  ########  #        #          #     #      # # ## #    # 
#####  ###  #  ##             #  #  ##############    #   #  ## #####  ######## # ####  ###### # ########  # 
#   #          ############                # #      # #####  #####  ######      # #      #   # #      # #  # 
 #          # #  #         #  #  #  #  ##############           #     ######### # #          #   #  ### #  # 
####   # ####  #  # ####   #######  #  ####  #      ########### ####  #     #   # ################  #   #  # 
#   #  ###  #  ####        #  #     #        #####  #  #    #      #  # # # #####  #  #    #    #   ######## 
#  ##       #        ###   #  #  ####  ####  #   #  #  #### #### # #### # #        #  #######   #  ##      # 
#      ###  #  #####   ####   #  #               #  #          # #      # #######  # ####  # ####  #   #   # 
#####  ###  #  ##             #  #  ##############  ###### # ######### ## #   #    # #  #### #  #  #  #### # 
#   #          ############   #     #      # #      ####   # #       # #  # # # #### #  #    ####  #  #    # 
############################################################################################################