############################################################################################################
#   ##   ########### $ ##############       ##                #     # #### $$     ###  $$    #        $$$  #
#$# ## ###       #                    ####   $  #############   # #    ######     ###  $$$   #    #        #
###    ###  ###  #    ### ######  ###   #########          ## ########    #   ##    ##       #    #        #
######     ####  ###  ### ######  #####  ########   ###### $  ##########  #    #      #####  #   #### ######
############$##  ###  ### ######  ######  #######   ## $###########       #    #####      #   ####    #    #
#            ##  ###                             # ####       ##     ######        #      #  #     ###     #
# ########            ####### ##### #####$$     ## #########   ###   # $$$      #######   #  #    #        #
# ############### ########### ##### #############              #     ############            #     #       #
#$$##          ## ##       ## ## ## ##    ###     ##  ##########           ##          #######    ###      #
#####  ###     ## ##          ## ##    ##    ## #####           # #######   #  #####  #            #$$     #
#     $           #         #### ########   #  #    #### #######  #         #    #    #    #############   #
###  ### #### ## ##### #### #          ####   #      $$$   #      # $$          #     #     #        ####  #
#### ##  ##########         # $   #       #######           # ################    ########  #    #         #
########   #### ###    ###### $   #    ##          #      #   #    $$$    ############      #    #    ######
#          #     ## ###    ###  ###        ###     #     #             #        #      ######         #  $$#
# $     #     #         #    ###      #####        #$$$#   ###         #      #        # $$      #    #    #
###### ########## #########   ##  # #     # ####   #####     #     #######      ##     #         #    #    #
#  ##    #    ##          $#       #       #     ##          #   ##    #  ###########  #####  #########    #
#  $###  #    ##  ####     ##########                  $###    #       #        #     #  ###  #            #
#     $###    #####  # ###  #   $$   #########      ######    #    #######      # ########    #            #
#                    #$#    #                   ####              #    $$###      #           #    ######  #
##############   #   ###  ###       # ####        #  #    ####   #         ###### #   ##   ####     #      #
#    #           #   ##   # $$     ## #  # ##    #   #    #    #########          #           #      # #   #
#  #     #       #      ###    #####  ## ######   #  #### #    #       #     ##  #####  #######   #   #    #
#   ##### ##############  #    #      #  $$   #         # #    #     $$#     # # # $$#    # $$    #        #
#                         #######     #  $$    #   #### # ##   #       #     #  ##   ##   #       #        #
#######  ####        ### ###     #    ##      ###  # $# #   #      $$#####   ###     #    #########        #
#     ####  ##########   #$       ##   #   ###     # $# #  #     ####    ##     #    #           #   $$$$  #
# $$$ #        #   ####  ####          #     #    ##  ###   #####     #   ####  #    #    #       #        #
#       ######                ###   ####       ####         #     ##### #      ##         #                #
#############################################################O##############################################