############################################################################################################
#      #          # #  #         #  #  #  #  ########   #        #  #  # #    # #      #  #  #     #  #    #     #  #  # #    # #      #  #  #     #  #    #                                #
####   # ####  #  # ####   #######  #  ####  #      #   #  #  ####  #### ######   ########  #  #  ## #  #     #   #  #  ####  #### ######   ## #
#   #  ###  #  ####        #  #     #        #####  #   #  ####     #      #    #         #  ##### #  #### #    ####     #      #    #         #  ##### #  #### #       #
#  ##       #        ###   #  #  ####  ####  #   #  #   ######   ######### #  ###   ####  #        #       #    ######   ######### #  ###   ####  #      #  
#      ###  #  #####   ####   #  #               #  #       #  ###       #    ###   #     #####  ### ####  #    #  ###       #    ###   #     #####  ### ####  #   #
#####  ###  #  ##             #  #  ##############  #  ###   #  ######## #      #   #  ####       #     ## #    #  #  ###   #  ######## #      #   #  ## #
#   #          ############                # #      #  #  ####  #      # # ###  # ###  #     ###  #  ###   #   ####  #      # # ###  # ###  #     ###  #  ###     #  
# ##########             ##   #########  ### #####     #   #       ##    ####   #####  #  ###  #  #     ####    ###     #   #       ##    ####   #####    # 
#          ############   #                        #####   #   #########    #          #  #    #  #######  #   #   #########    #          #  #    #  ######        #
########              #      ####  ##############  ##      #        #  #      ## ######   #    #      ###  # #  ##      #        #  #      ## ######   #    #      #
#         ####### #############         #   #      #   #####   #### #  #  ###### #  #  ####       ######   # #####   #### #  #  ###### #  #  ### # 
# #########     #      ##     #  #####  #  ######  #     #       #    #      #   # ####       #######  #   # #     #       #    #      #   # ####       #######    #  
#               #####  #   ####  #      #   #        #############  #################   ####  #      #  #   # ########  #################   #  # 
# ##########             ##   #########     ### #####     #   #       ##    ####   #####  #  ###  #  #     ####    ####     #   #       ##    ####   #### #   
#          ############   #                          #####   #   #########    #          #  #    #  #######  #    #   #########    #          #  #    #  #######   #  
########              #      ####  ##############  ##      #        #  #      ## ######   #    #      ###  #    # #      #  #  #     #  #    #                               #
#  ##      ###  ###   ####   ###         ###        #       ######    #      #######   ########       #### # ## #  #     #   #  #  ####  #### ######   ### 
#  #   #####       #             #######    #   ####            #       ####      ##      #          ####  #                  ##     #      #    #         #  ##### #  #### #     # 
#   #  ###  #  ####        #  #     #        #####  #   #  ####     #      #    #         #  ##### #  #### #              ######   ######### #  ###   ####  #     #
#  ##       #        ###   #  #  ####  ####  #   #  #   ######   ######### #  ###   ####  #        #       #  ###       #    ###   #     #####  ### ####  #  #
#      ###  #  #####   ####   #  #               #  #       #    ###       #    ###   #     #####  ### ####  #       # #    #  #  ###   #  ######## #      #   #  ###
#####  ###  #  ##             #  #  ##############  #    ###   #  ######## #      #   #  ####       #      ###  #      # # ###  # ###  #     ###  #  ###  #
#   #          ############                # #      #  #    ####  #      # # ###  # ###  #     ###  #  ###   #      ####    ###     #   #       ##    ####   #####  # 
 #          # #  #         #  #  #  #  ########   #        #  #  # #    # #      #  #  #     #  #    #                               #########    #          #  #    #  #######    # 
####   # ####  #  # ####   #######  #  ####  #      #   #  #  ####  #### ######   ########  #  #   #  ##      #        #  #      ## ######   #    #     # 
#   #  ###  #  ####        #  #     #        #####  #   #  ####     #      #    #         #  ##### #  #### #          ##   # #####   #### #  #  ###### #  #  ### # 
#  ##       #        ###   #  #  ####  ####  #   #  #   ######   ######### #  ###   ####  #        #       # #     #       #    #      #   # ####       #######   # 
#      ###  #  #####   ####   #  #               #  #       #  ###       #    ###   #     #####  ### ####  #          #   # ########  #################   # #
#####  ###  #  ##             #  #  ##############  #  ###   #  ######## #      #   #  ####       #     #    ####    ####     #   #       ##    ####   ##    #
#   #          ############                # #      #  #  ####  #      # # ###  # ###  #     ###  #  ###   #        #   #########    #          #  #    #  ####### # 
############################################################################################################