##############################################################################################################################
#		##		#	    	    				#									#			#		## # 																												 #
#			#		#	   #	 #	# 		####			#		#    #			#						 #																												 #
#	#		  #  	#	   #	 #			##		#	#		#		#					#		#		 #	                                                                                                             #
#		#  	##  	   #     ##					#			#			#				#				 # 																											 #
#	#					   #	#			#			#			#			#		#			###   	 # 																											 #
#			###			 #				#	#	#		#	#	#		#	#	#	#	#	#			  # #																												 #
#	##		#	    	    				#									#			#		##	 #																												 #	
#																										##	 #																												 #
#																										#		 #																												 #
#																										#		 #	 																											 #
#																												 #                                        																		 #
#																												 #																												 #			
#																												 #																												 #		
#																												 # 																											 # 
#																												 #                                                                                                              #
#																												 #																												 #
#																												 #																												 #
#																												 #																												 #
#																												 #																												 #
#																												 #																												 #	
#																												 #																												 #	
#																												 #																												 #			
#																												 # 																											 #	
#																												 #																												 #	
#																												 #																												 #	
#																												 #																												 #	
#																												 #																												 #	
#																												 #																												 #
#																												 #                                                                                                              #
#																												 #                                                                                                              #
##############################################################################################################################																											 #
#																												#																												 #
#																												#																												 #
#																												#																												 #
#																												#																												 #
#																												#																												 #
#																												#																												 #
#																												#																												 #
#																												#																												 #
#																												#																												 #
#																												#																												 #
#																												#																												 #
#																												#																												 #
#																												#																												 #
#																												#																												 #
#																												#																												 #
#																												#																												 #
#																												#																												 #
#																												#																												 #
#																											    #																												 #																												#																												 #
#																												#																												 #
#																												#																												 #
#																												#																												 #
#																												#																												 #
#																												#																												 #
#																												#																												 #
#																												#																												 #
#																												#																												 #
#																												#																												 #
#																												#																												 # 																										 		                                                                                                       
##############################################################################################################################
