############################################################################################################
#   ##   ########### $ ##############       ##                #     # #### $$     ###  $$    #        $$$  #
#$# ## ###       #                    ####   $  #############   # #    ######     ###  $$$   #    #        #
###    ###  ###  #    ### ######  ###   #########          ## ########    #   ##    ##       #    #        #
######     ####  ###  ### ######  #####  ########   ###### $  ##########  #    #      #####  #   #### ######
############$##  ###  ### ######  ######  #######   ## $###########       #    #####      #  #####    #    #
#            ##  ###                             # ####       ##     ######        #      #  #     ###     #
# ########            ####### ##### #####$$     ## #########   ###   # $$$      #######   #  #    #        #
# ############### ########### ##### #############              #     ############            #     #       #
#$$##          ## ##       ## ## ## ##    ###     ##  ##########           ##          #######    ###      #
#####  ###     ## ##   $$$    ## ##    ##    ## #####           # #######   #  #####  #            #$$     #
# $$              #         #### ########   #  #    #### #######  #         #    #    #    #############   #
###  ### #### ## ##### #### #          ####   #      $$$   #      # $$          #     #     #        ####  #
#### ##  ##########         # $   #       #######           # ################    ########  #    #         #
########   #### ###    ###### $   #    ##          #      #   #    $$$    ############      #    #    ######
#          #     ## ###    ###  ###        ###     #     #             #        #      ######         #  $$#
# $     #     #         #    ###      #####        #$$$#   ###         #      #$       # $$      #    #    #
###### ########## #########   ##  # #     # ####   #####     #     #######      ##     #         #    #    #
#  ##    #    ##          $        #       #     ##          #   ##    #   ##########  #####  #########    #
#  $###       ##  ####     ##########                  $###    #       #     ####     #  ###  #            #
##    $###    #####  # ##   #   $$   #########      ######    #    #######      # ########    #            #
####                 #$#    #                   ####   #         ##    $$###      #           #    ######  #
##############   #   ###  ###       # ####        #  #  # #####  #         ###### #   ##   ####     #      #
#   ##      ##   #   ##   # $$     ## #  #$##    #   #    #    #########          #           #      # #   #
###      #       #      ###    #####  ## ######   #  #### #    #       #     ##  #####  #######   #   #    #
#   ##### ##############  #    #      #  $$   #         # #    #     $$#     # # # $$#    # $$    #        #
#                         #######     #  $$    #   #### # #    #       #     #  ##   ##   #       #        #
#######  ####        ### ###     #    ##      ###  # $# #   #      $$#####   ###     #    #########        #
#     ####  ##########   #$       ##  ##   ###     # $# #  # ###  ###    ##     #    #           #   $$$$  #
# $$$ #        #   ####  ####              ###    ##  # #   #####     #   ####  #    #    #       #        #
#       ######                ###   ####       #####        #     ##### #      ##         #                #
#############################################################O##############################################