############################################################################################################
#      #          # #  #         #  #  #  #  ########   #        #  #  # #    # #      #  #  #     #  #    # 
####   # ####  #  # ####   #######  #  ####  #      #   #  #  ####  #### ######   ########  #  #  ## #  #  # 
#   #  ###  #  ####        #  #     #        #####  #   #  ####     #      #    #         #  ##### #  #### # 
#  ##       #        ###   #  #  ####  ####  #   #  #   ######   ######### #  ###   ####  #        #       # 
#      ###  #  #####   ####   #  #               #  #       #  ###       #    ###   #     #####  ### ####  # 
#####  ###  #  ##             #  #  ##############  #  ###   #  ######## #      #   #  ####       #     ## # 
#   #          ############                # #      #  #  ####  #      # # ###  # ###  #     ###  #  ###   # 
# ##########             ##   #########  ### #####     #   #       ##    ####   #####  #  ###  #  #     #### 
#          ############   #                        #####   #   #########    #          #  #    #  #######  # 
########              #      ####  ##############  ##      #        #  #      ## ######   #    #      ###  # 
#         ####### #############         #   #      #   #####   #### #  #  ###### #  #  ####       ######   # 
# #########     #      ##     #  #####  #  ######  #     #       #    #      #   # ####       #######  #   # 
#               #####  #   ####  #      #   #         ############  #################   ####  #      #  #  # 
# ##########             ##   #########     ### #####    #   ############ #############                    # 
#          ############   #                           ####   #    #     #    #        #                    #
########              #      ####  ##############  ####  #######  #  #  #### # #####  #                    #
#  ##      ###  ###   ####   ###         ###        #    #        #  #    # ## #      #                    #
#  #   #####       #             #######    #   ####   ### #####  # ##### # #######   #                    #
#   #  ###  #  ####        #  #     #        #####  #  #   #  #     #  #  #                                #
#  ##       #        ###   #  #  ####  ####  #   #  #      #  ######## ########## #                        #
#      ###  #  #####   ####   #  #               #  ########  #        #          #                        #
#####  ###  #  ##             #  #  ##############    #   #  ## #####  ######## # ####   #####             #
#   #          ############                # #      # #####  #####  ######      # #      #   #             #
 #          # #  #         #  #  #  #  ##############           #     ######### # #          #             #
####   # ####  #  # ####   #######  #  ####  #      ########### ####  #     #   # #############            #
#   #  ###  #  ####        #  #     #        #####  #  #    #      #  # # # #####                          #
#  ##       #        ###   #  #  ####  ####  #   #  #  #### #### # #### # #                                #
#      ###  #  #####   ####   #  #               #  #          # #      # #######                          #
#####  ###  #  ##             #  #  ##############  ###### # ######### ## #   #                            #
#   #          ############                # #      ####   # #       # #  # # #                            #
############################################################################################################