########################################################################################################## #
#      #          # #  #         #  #  #  #  ########   #        #  #  # #    # #      #  #  #     #  #    # 
####   # ####  #  # ####   #######  #  ####  #      #   #  #  ####  #### ###### ########  #  #  ## #  #    # 
#   #  ###  #  ####        #  #     #        #####  #   #  ####     #      #    #         #  ##### #  #### # 
#  ##       #        ###   #  #  ####  ####  #   #  #   ######   ######### #  ###   ####  #        #       # 
#      ###  #  #####   ####   #  #               #  #       #  ###       #    ###   #     #####  ### ####  # 
#####  ###  #  ##             #  #  ##############  #  ###   #  ######## #      #   #  ####       #     ## # 
#   #          ############                # #      #  #  ####  #      # # ###  # ###  #     ###  #  ###   # 
# ##########             ##   #########  ### #####     #   #       ##    ####   #####  #  ###  #  #     #### 
#          ############   #                        #####   #   #########    #          #  #    #  #######  # 
########              #      ####  ##############  ##      #        #  #      ## ######   #    #      ###  # 
#         ####### #############         #   #      #   #####   #### #  #  ###### #  #  ####       ######   # 
# #########     #      ##     #  #####  #  ######  #     #       #    #      #   # ####       #######  #   # 
#               #####  #   ####  #      #   #       #############  #################   ####  #      #  #   # 
##########  #    #     ####      #                                                    			           #
#        #####  ## ####         #      #        ###          #####     ########  ## ##         #    ###    # 
#   ######      ##  #         #         ##     ###   #     #                 ##          #######        ####
#  ##      ###  ###   ####   ###         ###        #       ######    #      #######   ########       #### # 
#  #   #####       #             #######    #   ####            #       ####      ##      #          ####  # 
#          #########     #     ####          #####       ####     ########      ###      #         ###     # 
###   #######     ########        #           ###  # #   #######      ####                      ##   #     #
##   ###   #####          ####        ########      ####      ###      ###     #   #####      ###      ##  # 
#  ####             ####                #               #              ##    #        ###       #    #    ##
#           #####                ####        #  #####   #####          #######        ##    ###     #      #
############################################################################################################